0 3 4 5 6 7
1 4 5 6 7
2 4 5 6 7
3 0 5 6 7
4 0 1 2
5 0 1 2 3
6 0 1 2 3
7 0 1 2 3